00000000000000000000000000000000000000000000000000000000000000000000000000000000000000
00000000000000000000000000000000000000000000000000000000000000000000000000000000000000
00000000000000000000000000000000000000000000000000000000000000000000000000000000000000
00000000000000000000000000000000000000000000000000000001111111111111111111111111111110
00000000000000000000000000000000000000000000000000000001000000000000000000011111111110
00000000000000000000000000000000000000000000000000000001000000000000000000011111111110
00000000000000000000000000000000000000000000000000000001000000000000000000011111000010
00000000000000111111100000000000000000000000000000000001000000000000000000011111000010
00777110000000111111100000000000000000000000000000000001000000000000000000001111000010
00777110000000111111111111111111111111111111110000000001000000000000000000011111000010
00000000000000111111111111111111111111111111110000000001000000000000000000011110000010
00000000000000111111111111111110000000000000000000000001000000000000000000011110000010
00000000000000111111111111111110000000000000000000000001000000000000000000011110000010
00000000000000111111111111111110000000000000000000000001000000000000000000011110000010
00000000000000111111111111111110000000000000000000000001000000000000000000011110000010
00000000000000111111111111111110000000000000000000000001000000000000000000011111111110
00000000000000111111111111111110000000000000000000000001000000000000000000011111111110
00000000000000111111111111111110000000000000000000000001000000000000000000011111111110
00066111111111111111111111111110000000000000000000000001000000000000000000011155555110
00066111111111111111111111111110000000000000000000000001111111111111111111111155555110
00011111111111111111111111111110000000000000000000000000000000000000000000000000000000
00000000001111111111111111111111111111111111111111110000000000000000000000000000000000
00000000001111111111111111111100000111111111110001100000000000000000000000000000000000
00000000001111111111111111111100000111111111110001100000000000000000000000000000000000
00000000001111111111111111100000000111111111110001100000000000000000000000000000000000
00000000001111111111111111100000000111111111110001100000000000000000000000000000000000
00000000001111111111111111100000000111111111110001100000000000000000000000000000000000
00000000001111111111111111100000000111111111110000000000000000000000000000000000000000
00000000001111111111111111100000000111111111110000000110000000000000000000011114441000
00011111111111111111111111100000000111111111110000000110000000000000000000011114441000
00011111111111111111111111100000000111111111110000000110000000000000000000011111111000
00011111111111111111111111100000000111100001110000000110000000000000000000011111111000
00011111111111111111111111100000000111100001110000000110000000000000000000011111111000
00011111111111111111111111100000000111100001110000000110000000000000000000011111111000
00000000000111111111111111100000000111100001110000000110000000000000000000011111111000
00000000000111111111111111100000000000000000000000000110000000000000000000011111111000
00000000000111111111111111100000000000000000000000000110000000000000000000011111111000
00000000000111111111111111100000000000000000000000000110000000000000000000011111111000
00000000000111111111111111100000000000000000000000000110000000000000000000011111111000
00000000000111111111111111111110000011111111100000111111111111111111111111111111111000
00000000000111111111111111111111100011111111100011111111111111111111111111111111111000
00000000000111111111111111111111100011111111100011111111111111111111111111111111111000
00011111111111111111111111111111111111111111111111111111111111111111111111111111111000
00011111111111111111111111111111111111111111111111111111111111111111111111111111111000
00011111111111111111111111111111111111111111111111111111111111111111111111111111111000
00011111111111111111111111111111111111111111111111111111111111111111111111111111111000
00011111111111111111111111111111111111111111111111111111111111111111111111111111111000
00011111111111111111111111111111111111111111111111111111111111111111111111111111111000
00000000000000001111111111111111111111111000111000111111111111111111111111111111111000
00000000000000001111111111111100000011111000111000111111111111111111111111111111111000
00000000000000001111111111111100000011111000111000111111111111111111111111111222221000
00000000000000001111111111111100000011111000111000111111111111111111111111111222221000
00000000000000001111111111111100000011111000111000111111111100000000000000000000000000
00000000000000001111111111111100000011111111111111111111111100000000000000000000000000
00000000000000001111111111111100000011111111111111111111111000000000000000000000000000
00000000000000001111111111111100000011111111111111111111111000000000000000000000000000
00000000000000001111111111111100000011111111111111111111111000000000000000000000000000
00000000000000000111111111111100000011111111000011111111111000000000000000000000000000
00000000000000000000000111111100000011111111000011111111111000000000000000000000000000
00000000000000000000000111111100000011111111000011111111111000000000000000000000000000
00000000000000000000000001111100000011111111000011111111111000000000000000000000000000
00000000000000000000000001111100000011111111000011111111111000000000000000000000000000
00000000000000000000000001111100000011111111000011111111111000011111001111111333311110
00000000000000000000000001111100000011111111111111111111111000011111111111111333311110
00000000000000000000000001111100000011111111111111111111111000011111111111111111111110
00000000000000000000000000000000000000000000000000000000000000011111111111111111111110
00000000000000000000000000000000000000000000000000000000000000011111111111111111111110
00000000000000000000000000000000000000000000000000000000000000011111111111111111111110
00000000000000000000000000000000000000000000000000000000000000000000000000000000000000
00000000000000000000000000000000000000000000000000000000000000000000000000000000000000