00000000000000000000000000000000000000000000000000000000000000000000000000000000000000
00000000000000000000000000000000000000000000000000000000000000000000000000000000000000
00000000000000000000000000000000000000000000000000000000000000000000000000000000000000
00000000000000000000000000000000000000000000000000000001111111111111111111111111111110
00000000000000000000000000000000000000000000000000000001000000000000000000011111111110
0000000000000000000000000000000000000000000000000000000100000000000000000001111CCCCCC0
0000000000000000000000000000000000000000000000000000000100000000000000000001111C0000C0
0000000000000011111110000000000000000000000000000000000100000000000000000001111C0000C0
0077788000000011111110000000000000000000000000000000000100000000000000000000111C0000C0
007778800000001111111111111111111111111111111100000000010000000000000000000111CC0000C0
000000000000001111111111111111111111111111111100000000010000000000000000000111C00000C0
000000000000001111111111111111100000000000000000000000010000000000000000000111C00000C0
000000000000001111111111111111100000000000000000000000010000000000000000000111C00000C0
000000000000001111111111111111100000000000000000000000010000000000000000000111C00000C0
000000000000001111111111111111100000000000000000000000010000000000000000000111C00000C0
000000000000001111111111111111100000000000000000000000010000000000000000000111CCCCCCC0
00000000000000111111111111111110000000000000000000000001000000000000000000011111111110
00000000000000111111111111111110000000000000000000000001000000000000000000011111111110
00066111111111111111111111111110000000000000000000000001000000000000000000011155555110
00066111111111111111111111111110000000000000000000000001111111111111111111111155555110
00011111111111111111111111111110000000000000000000000000000000000000000000000000000000
00000000001111111111111111111111111111111111111111110000000000000000000000000000000000
00000000001111111111111111111100000111111111110001100000000000000000000000000000000000
00000000001111111111111111111100000111111111110001100000000000000000000000000000000000
00000000001111111111111111100000000111111111110001100000000000000000000000000000000000
00000000001111111111111111100000000111111111110001100000000000000000000000000000000000
00000000001111111111111111100000000111111111110001100000000000000000000000000000000000
00000000001111111111111111100000000111111111110000000000000000000000000000000000000000
00000000001111111111111111100000000111111111110000000110000000000000000000011114441000
00011111111111111111111111100000000111111111110000000110000000000000000000011114441000
00011111111111111111111111100000000111111111110000000110000000000000000000011111111000
00011111111111111111111111100000000111100001110000000110000000000000000000011111111000
00011111111111111111111111100000000111100001110000000110000000000000000000011111111000
00011111111111111111111111100000000111100001110000000110000000000000000000011111111000
00000000000111111111111111100000000111100001110000000110000000000000000000011111111000
00000000000111111111111111100000000000000000000000000110000000000000000000011111111000
00000000000111111111111111100000000000000000000000000110000000000000000000011111111000
00000000000111111111111111100000000000000000000000000110000000000000000000011111111000
00000000000111111111111111100000000000000000000000000110000000000000000000011111111000
000000000001111111111111111111100000111WWWW1100000111111111111111111111111111111111000
00000000000111111111111111111111100011111111100011111111111111111111111111111111111000
00000000000111111111111111111111100011111111100011111111111111111111111111111111111000
00011111111111111111111111111111111111111111111111111111111111111111111111111111111000
00011111111111111111111111111111111111111111111111111111111111111111111111111111111000
00011111111111111111111111111111111111111111111111111111111111111111111111111111111000
00011111111111111111111111111111111111111111111111111111111111111111111111111111111000
00011111111111111111111111111111111111111111111111111111111111111111111111111111111000
00099999999999999111111111111111111111111AAA111BBB111111111111111111111111111111111000
0000000000000000911111111111111111111111A000A1B000B11111111111111111111111111111111000
0000000000000000911111111111110000001111A000A1B000B11111111111111111111111111111111000
0000000000000000911111111111110000001111A000A1B000B11111111111111111111111111222221000
0000000000000000911111111111110000001111A000A1B000B11111111111111111111111111222221000
0000000000000000911111111111110000001111A000A1B000B11111111100000000000000000000000000
00000000000000009111111111111100000011111AAA111BBB111111111100000000000000000000000000
00000000000000009111111111111100000011111111111111111111111000000000000000000000000000
00000000000000009111111111111100000011111111111111111111111000000000000000000000000000
0000000000000000991111111111110000001111111YYYYY11111111111000000000000000000000000000
0000000000000000099999991111110000001111111Y0000Y1111111111000000000000000000000000000
0000000000000000000000091111110000001111111Y0000Y1111111111000000000000000000000000000
0000000000000000000000099911110000001111111Y0000Y1111111111000000000000000000000000000
0000000000000000000000000911110000001111111Y0000Y1111111111000000000000000000000000000
0000000000000000000000000911110000001111111Y0000Y1111111111000000000000000000000000000
0000000000000000000000000911110000001111111Y0000Y111111111100001111P00P111111333311110
0000000000000000000000000911110000001111111YYYYYY111111111100001111PPPP111111333311110
00000000000000000000000009111100000011111111111111111111111000011111111111111111111110
00000000000000000000000000000000000000000000000000000000000000011111111111111111111110
00000000000000000000000000000000000000000000000000000000000000011111111111111111111110
00000000000000000000000000000000000000000000000000000000000000011111111111111111111110
00000000000000000000000000000000000000000000000000000000000000000000000000000000000000
00000000000000000000000000000000000000000000000000000000000000000000000000000000000000