00000000000000000000000000000000000000000000000000000000000000000000000000000000000000
00000000000000000000000000000000000000000000000000000000000000000000000000000000000000
00000000000000000000000000000000000000000000000000000000000000000000000000000000000000
00000000000000000000000000000000000000000000000000000000000000000000000000000000000000
00000000000000000000000000000000000000000000000000000000000000000000000000000000000000
00000000000000000000000000000000000000000000000000000000000000000000000000011111111111
00000000000000000000000000000000000000000000000000000000000000000000000000011111111111
00000000000000111111100000000000000000000000000000000000000000000000000000011111111111
00000000000000111111100000000000000000000000000000000000000000000000000000001111000111
00011111000000111111100000000000000000000000000000000000000000000000000000011111000011
00011111000000111111111111111111111111111111110000000000000000000000000000011110000011
00011111000000111111111111111111111111111111110000000000000000000000000000011110000011
00000000000000111111111111111111111111111111110000000000000000000000000000011110000011
00000000000000111111111111111110000000000000000000000000000000000000000000011110000011
00000000000000111111111111111110000000000000000000000000000000000000000000011110000011
00000000000000111111111111111110000000000000000000000000000000000000000000011111111111
00000000000000111111111111111110000000000000000000000000000000000000000000011111111111
00000000000000111111111111111110000000000000000000000000000000000000000000011111111111
00011111111111111111111111111110000000000000000000000000000000000000000000011111111111
00011111111111111111111111111110000000000000000000000000111111111111111111111111111111
00011111111111111111111111111110000000000000000000000000111111111111111111111111111111
00011111111111111111111111111110000000000000000000000000111111111111111111111111111111
00011111111111111111111111111111111111111111111111100000111111111111111111111111111111
00000000001111111111111111111111111111111111111111100000000000000000000000000000000000
00000000001111111111111111111110000111111111110001100000000000000000000000000000000000
00000000001111111111111111111110000111111111110001100000000000000000000000000000000000
00000000001111111111111111000000000111111111110001100000000000000000000000000000000000
00000000001111111111111111000000000111111111110001100000000000000000000000000000000000
00000000001111111111111111000000000111111111110000000110000000000000000000011111111000
00011111111111111111111111000000000111111111110000000110000000000000000000011111111000
00011111111111111111111111000000000111111111110000000110000000000000000000011111111000
00011111111111111111111111000000000111111111110000000110000000000000000000011111111000
00011111111111111111111111000000000111111111110000000110000000000000000000011111111000
00011111111111111111111111000000000111100011110000000110000000000000000000011111111000
00011111111111111111111111000000000111100011110000000110000000000000000000011111111000
00011111111111111111111111000000000111100011110000000110000000000000000000011111111000
00000000000111111111111111000000000000000000000000000110000000000000000000011111111000
00000000000111111111111111000000000000000000000000000110000000000000000000011111111000
00000000000111111111111111000000000000000000000000000110000000000000000000011111111000
00000000000111111111111111111110000000000000000000111110000000000000000000011111111000
00000000000111111111111111111111100111111111100011111111111111111111111111111111111000
00000000000111111111111111111111100111111111100011111111111111111111111111111111111000
00000000000111111111111111111111111111111111111111111111111111111111111111111111111000
00011111111111111111111111111111111111111111111111111111111111111111111111111111111000
00011111111111111111111111111111111111111111111111111111111111111111111111111111111000
00011111111111111111111111111111111111111111111111111111111111111111111111111111111000
00011111111111111111111111111111111111111111111111111111111111111111111111111111111000
00011111111111111111111111111111111111111111111111111111111111111111111111111111111000
00011111111111111111111111111111111111111111111111111111111111111111111111111111111000
00011111100011111111111111111111111111111100111001111111111111111111111111111111111000
00011110000000111111111111111111111111111100111001111111111111111111111111111111111000
00011000000000011111111111111100000011111100111001111111111111111111111111111111111000
00000000000000011111111111111100000011111100111001111111111111111111111111111111111000
00000000000000011111111111111100000011111100111001111111111111111111111111111111111000
00000000000000001111111111111100000011111111111111111111111000000000000000000000000000
00000000000000001111111111111100000011111111111111111111111000000000000000000000000000
00000000000000001111111111111100000011111111111111111111111000000000000000000000000000
00000000000000000111111111111100000011111111111111111111111000000000000000000000000000
00000000000000000001111111111100000011111111111111111111111000000000000000000000000000
00000000000000000000011111111100000011111111100111111111111000000000000000000000000000
00000000000000000000000111111100000011111111000011111111111000000000000000000000000000
00000000000000000000000111111100000011111111000011111111111000000000000000000000000000
00000000000000000000000111111100000011111111000011111111111000000000000000000000000000
00000000000000000000000111111100000011111111000011111111111000011111100111111111111111
00000000000000000000000111111100000011111111111111111111111000011111111111111111111111
00000000000000000000000111111100000011111111111111111111111000011111111111111111111111
00000000000000000000000111111100000011111111111111111111111000011111111111111111111111
00000000000000000000000000000000000000000000000000000000000000011111111111111111111111
00000000000000000000000000000000000000000000000000000000000000011111111111111111111111
00000000000000000000000000000000000000000000000000000000000000011111111111111111111111