00000000000000000000000000000000000000000000000000000001111111111111111111111111111110
00000000000000000000000000000000000000000000000000000001000000000000000000011111111110
0000000000000000000000000000000000000000000000000000000100000000000000000001111CCCCCC0
0000000000000000000000000000000000000000000000000000000100000000000000000001111C0000C0
0000000000000011111110000000000000000000000000000000000100000000000000000001111C0000C0
0077788000000011111110000000000000000000000000000000000100000000000000000000111C0000C0
00777880000000111111111111111111111111111111SS00000000010000000000000000000111CC0000C0
00000000000000111111111111111111111111111111SS00000000010000000000000000000111C00000C0
000000000000001111111111111111100000000000000000000000010000000000000000000111C00000C0
000000000000001111111111111111100000000000000000000000010000000000000000000111C00000C0
000000000000001111111111111111100000000000000000000000010000000000000000000111C00000C0
000000000000001111111111111111100000000000000000000000010000000000000000000111C00000C0
000000000000001111111111111111100000000000000000000000010000000000000000000111CCCCCCC0
00000000000000111111111111111110000000000000000000000001000000000000000000011111111110
00000000000000111111111111111110000000000000000000000001000000000000000000011111111110
00066111111111111111111111111110000000000000000000000001000000000000000000011155555110
00066111111111111111111111111110000000000000000000000001111111111111111111111155555110
00011111111111111111111111111110000000000000000000000000000000000000000000000000000000
00000000001111111111111111111111111111111111111111110000000000000000000000000000000000
00000000001111111111111111111100000111111111110001100000000000000000000000000000000000
00000000001111111111111111111100000111111111110001100000000000000000000000000000000000
00000000001111111111111111100000000111111111110001100000000000000000000000000000000000
00000000001111111111111111100000000111111111110001100000000000000000000000000000000000
00000000001111111111111111100000000111111111110001100000000000000000000000000000000000
00000000001111111111111111100000000111111111110000000000000000000000000000000000000000
00000000001111111111111111100000000111111111110000000110000000000000000000011114441000
00011111111111111111111111100000000111111111110000000110000000000000000000011114441000
00011111111111111111111111100000000111111111110000000110000000000000000000011111111000
00011111111111111111111111100000000111100001110000000110000000000000000000011111111000
00011111111111111111111111100000000111100001110000000110000000000000000000011111111000
00011111111111111111111111100000000111100001110000000110000000000000000000011111111000
00000000000111111111111111100000000000000000000000000110000000000000000000011111111000
00000000000111111111111111100000000000000000000000000110000000000000000000011111111000
00000000000111111111111111100000000000000000000000000110000000000000000000011111111000
00000000000111111111111111100000000000000000000000000110000000000000000000011111111000
00000000000111111111111111100000000000000000000000000110000000000000000000011111111000
000000000001111111111111111111100000WWWWWWWWW0000011111MMMMMMMMMMMMMMMMMMMM11111111000
00000000000111111111111111111111100011111111100011111111111111111111111111111111111000
00000000000111111111111111111111100011111111100011111111111111111111111111111111111000
11111111111111111111111111111111111111111111111111111111111111111111111111111111111000
00011111100011111111111111111111111111111100111001111111111111111111111111111111111000
00011110000000111111111111111111111111111100111001111111111111111111111111111111111000
00011000000000011111111111111100000011111100111001111111111111111111111111111111111000
00000000000000011111111111111100000011111100111001111111111111111111111111111111111000
00000000000000011111111111111100000011111100111001111111111111111111111111111111111000
00000000000000001111111111111100000011111111111111111111111000000000000000000000000000
00000000000000001111111111111100000011111111111111111111111000000000000000000000000000
00000000000000001111111111111100000011111111111111111111111000000000000000000000000000
00000000000000000111111111111100000011111111111111111111111000000000000000000000000000
00000000000000000001111111111100000011111111111111111111111000000000000000000000000000
00000000000000000000011111111100000011111111100111111111111000000000000000000000000000
00000000000000000000000111111100000011111111000011111111111000000000000000000000000000
00000000000000000000000111111100000011111111000011111111111000000000000000000000000000
00000000000000000000000111111100000011111111000011111111111000000000000000000000000000
00000000000000000000000111111100000011111111000011111111111000011111100111111111111111
00000000000000000000000111111100000011111111111111111111111000011111111111111111111111
00000000000000000000000111111100000011111111111111111111111000011111111111111111111111
00000000000000000000000111111100000011111111111111111111111000011111111111111111111111
00000000000000000000000000000000000000000000000000000000000000011111111111111111111111
00000000000000000000000000000000000000000000000000000000000000011111111111111111111111
00000000000000000000000000000000000000000000000000000000000000011111111111111111111111

